######################################################
#                     #                              #
#  o                  #                              #
#                     #         c                    #
#                     #                              #
#                     #                              #
#                     #                 #            #
#                     #                 #            #
#                                       #      X     #
#                                       #            #
#                                       #            #
######################################################
