######################################################
#                                                    #
#  o                                                 #
#                                                    #
#                                                    #
#                                                    #
#                                       #            #
#                                       #            #
#                                       #      X     #
#                                       #            #
#                                       #            #
######################################################
